1111111111111111111111111111111
1000000001000010000000000100001
100000000100000000000000000E001
1000000PC0000010C00000000111111
1000z0000100000000000z000000001
1000001000000010000000000000001
1000000001000000000000011000001
1001000001000010000000011000001
1000000C0000000C000000000z00001
1111111111111111111111111111111