11111111111111111111111111111
10000000010000100000000010001
100000000100000000000000Z0E01
1000000PC00000100000000011111
1000z000010000000000z00000001
10000010000000100000000000001
10000000010000000000001100001
10010000010000100000001100001
10010000010000100000001100001
10010000010000100000001100001
10010000010000100000001100001
10010000010000100000001100001
1000000C0000000C00000000z0001
11111111111111111111111111111