11111111111111111111111111111
10P00000010000100000000100001
10000000010000100000000Z0E001
1000000000000010C000000111111
1000z000010000000000000000001
10000000010000100000000000001
10000000010000100000000000001
10000000010000100000000000001
1000000C0000000C0000000z00001
11111111111111111111111111111
