1111111111111111111
10P0010010000100001
100001001000000E001
1000000010C00111111
1000010000000000001
1000010010000000001
1000010010000000001
1000010010000000001
100C00000C000000001
1111111111111111111
