1111111111111111
1C00000z00000001
1P00000000010001
100000E000010001
1000000000010001
1CC0000000000z01
1111111111111111