1111111111111111111
1000C000000000000z1
1P00C0000E000000001
1111111111111111111
