1111111111
1z001C0001
1P00000E11
1111111111
