1111111111
1C000000z1
1P0E000001
1111111111
