1111111111
1C00000*C1
1P00000ZE1
1111111111
