1111111111111111111111111111111
1000000010000100P00000000100001
100000000100001000000000000E001
1000000000000010C00000000111111
1000z0000100001000000z000000001
1000000001000010000000000000001
1000000C0000001C000000000z00001
1111111111111111111111111111111
